#########################################################################################################
#          #     #       #  ###     #           #                         #     #      #   # b          #
# #    #       #       #      #     #           #    ####    # ############     #      #   #########    #
#      #                   #  #  #  #       #   #    #       #                  #      #                #
#      #        #          #     #          #   #    #       ###         #####  #    #####         ######
#   #           #            ##############     #            #             #    #                       #
#      ##       #                               #   ##       #             #    #       #      ####     #
#####  ##       #       #            #          #     # ###############    #    #       #               #
#      ##                  ####  #  #       #   #    #       #        #         #                       #
#      ######## #          #     #          #   #    #       ###      #  #####  #    #####         ######
#####  ##       #       #            #           #    #            ####    #    #       ##              #
#      ##  #               #  ####  #       #   #    #       #     #            #        #              #
#      ##  #    #          #     #          #   #    #       ###   #     #####  #    #####         ######
#   #      #    #                               #            #     #       #    #                       #
#      #   #    ##################              #   ##       #     #       #    #       ##     ####     #
#      #   #                     #   ###                  ####  ####      ##    #                      ##
# #    #   #   #       ###       #              #      #        #          #    ################### #####
#  #       #####         #                     #            #   #         #             #               #
# # #    ###     #       #            #           ######        #######     #           ####            #
#                       ####  #  #  #       #   #    #       #        #                                 #
#      ####### ##                #          #   #    #       ###         #####       #####         ######
#   #       ## #  #########################     #            #      #      #             #              #
#      #        #                         #     #   ##       #      #      #            ##     ####     #
#      #        #  ###########   #   ###  #               ## #      #     ##          ####             ##
# #    #        #      #         #        #     #      #     ###    #      ########          #          #
#    #        ###      #                  #   #   ##       #        #      #          ##     ####     ###
#      #               ######    #   ###  #               ## #      #     ##          ###       #       #
# #    #       ##      #    #    #              #      #            #      #               #    #       #
# #   #        #       #    #   #   ###                  ## # ##### #######          ####  #    ####### #
# #    #       #       #    #    #              #      #          # #      #               #    #     # #
e ##   #   #   #       #             #######    # # ####     # #        #           #      #    #       #
#########################################################################################################
