#######
#  #  #
#  # b#
#  #  #
e     #
#     #
#######
